PLAYER,ELVEN_10,ELVEN_15,ELVEN_20,ELVEN_25,ELVEN_30,CURSED_20,CURSED_25,TOTAL
Granidred,172,429,98,0,0,12,0,711
Heretical Hermit,0,0,0,0,650,0,0,650
Alberikh,0,0,11,99,0,210,1,321
Xan,3,132,0,0,0,78,0,213
NEVIO,0,3,22,0,0,165,0,190
Snowberry,164,11,1,0,0,6,0,182
Tumitac,0,0,5,78,0,1,92,176
Karodor,0,0,0,3,0,0,172,175
Brandemet,1,4,2,6,63,19,56,151
Diabolik,61,73,12,0,0,0,0,146
Diovani,97,30,5,0,0,2,0,134
Marcelo,32,53,8,0,0,30,1,124
Rhodry,17,0,0,0,11,0,78,106
LUCKY BEAR,0,98,1,0,0,3,0,102
Amginir,26,27,28,0,0,17,0,98
Menelaos,9,16,29,4,0,4,2,64
Mr BaCk,1,9,15,18,2,3,6,54
Mighty Forger,0,0,37,12,0,0,0,49
Legolas,6,15,20,1,0,4,0,46
Sir James III Son of Hadur,0,21,9,16,0,0,0,46
Sir RES,16,19,8,0,0,0,0,43
Rudolf,1,4,25,0,0,7,5,42
Fabrinir,0,0,5,16,0,0,19,40
Marvi,8,6,17,1,0,7,0,39
Defur,32,5,0,0,0,0,0,37
MILI,19,13,4,0,0,0,0,36
Gradog,0,5,0,30,0,0,0,35
Hulk,0,0,0,0,35,0,0,35
Kosti,0,2,23,0,0,10,0,35
Grikelv,0,11,13,0,0,10,0,34
White Knight,10,19,2,3,0,0,0,34
Thoth,0,28,5,0,0,0,0,33
Monaoka,0,26,6,0,0,0,0,32
Feli,0,5,5,9,1,4,7,31
Mal,0,0,0,2,27,0,0,29
Berohef,10,18,0,0,0,0,0,28
Foolish Mortal,6,4,15,1,0,2,0,28
Germanicus,1,0,0,12,9,0,5,27
MADMAN,0,8,17,0,0,0,0,25
Mabrinad,0,0,13,3,0,7,2,25
Rainblade,6,13,5,0,0,0,0,24
Nilaath,2,0,15,6,0,0,0,23
Foxhunter,3,0,2,6,1,0,10,22
Lirinir,0,0,0,8,12,0,1,21
Funfiren,7,11,0,0,0,2,0,20
Uhtred,0,0,2,4,0,3,11,20
MONTES P,19,0,0,0,0,0,0,19
doc48,4,2,10,0,3,0,0,19
Lady G,11,7,0,0,0,0,0,18
Morg,0,0,11,0,1,5,0,17
Braveheart,0,1,14,0,0,1,0,16
Fosida,2,6,1,0,0,5,0,14
Immortal,0,1,3,6,0,1,3,14
Racibor,0,6,3,0,0,4,0,13
Eydaen,9,2,1,0,0,0,0,12
Grozilkree,1,5,5,0,0,1,0,12
Portia,4,8,0,0,0,0,0,12
Vlad the Impaler,2,6,4,0,0,0,0,12
Bamsi,3,3,5,0,0,0,0,11
Logan,0,7,4,0,0,0,0,11
Golgotha,0,1,9,0,0,0,0,10
Magda Ewa,0,6,4,0,0,0,0,10
Jaakarhu,0,4,1,4,0,0,0,9
Masius,6,2,1,0,0,0,0,9
Sir Doc,7,0,0,0,0,0,0,7
Maveriel,4,0,0,0,0,0,0,4
Rudepravo Italiano,0,2,0,0,0,1,0,3
Vugul,1,0,2,0,0,0,0,3
AlexLeroc,1,0,0,0,0,1,0,2
Sir Cthulhu I,0,1,1,0,0,0,0,2
Darvenen,1,0,0,0,0,0,0,1
Kirimand,0,1,0,0,0,0,0,1
Lorfanor,0,1,0,0,0,0,0,1
Maedrosin,0,0,1,0,0,0,0,1
Marvina,0,1,0,0,0,0,0,1
Well Constantino,0,0,1,0,0,0,0,1
idaco,0,0,0,0,0,0,1,1
3CPo,0,0,0,0,0,0,0,0
Accelerator,0,0,0,0,0,0,0,0
Aegrosad,0,0,0,0,0,0,0,0
Akinomuro,0,0,0,0,0,0,0,0
Alexander Greek,0,0,0,0,0,0,0,0
Archie,0,0,0,0,0,0,0,0
Arni,0,0,0,0,0,0,0,0
Bad FutherMucker,0,0,0,0,0,0,0,0
Bjorn,0,0,0,0,0,0,0,0
Black Mamba,0,0,0,0,0,0,0,0
Brann Bronzebeard,0,0,0,0,0,0,0,0
Braveheart JNR,0,0,0,0,0,0,0,0
Brightskin,0,0,0,0,0,0,0,0
Bubino71,0,0,0,0,0,0,0,0
Bunnyman,0,0,0,0,0,0,0,0
Cain,0,0,0,0,0,0,0,0
Catty,0,0,0,0,0,0,0,0
Cenaya,0,0,0,0,0,0,0,0
Cerim,0,0,0,0,0,0,0,0
Cesarz Saleka,0,0,0,0,0,0,0,0
Cesarzowa Cwieka,0,0,0,0,0,0,0,0
Conjudred,0,0,0,0,0,0,0,0
Cosmic Dancer,0,0,0,0,0,0,0,0
Cyril Figgis,0,0,0,0,0,0,0,0
D23,0,0,0,0,0,0,0,0
DAJMITU,0,0,0,0,0,0,0,0
DON IRON MIKE TYSON,0,0,0,0,0,0,0,0
Dabb,0,0,0,0,0,0,0,0
Dacage,0,0,0,0,0,0,0,0
Dafur,0,0,0,0,0,0,0,0
DarkAngel,0,0,0,0,0,0,0,0
Deep Inside,0,0,0,0,0,0,0,0
Digore,0,0,0,0,0,0,0,0
Doctor Krieger,0,0,0,0,0,0,0,0
Dr Bruce BANNER,0,0,0,0,0,0,0,0
Dragon Armor,0,0,0,0,0,0,0,0
Drugo,0,0,0,0,0,0,0,0
Dugul,0,0,0,0,0,0,0,0
EL CHAPO GUZMAN,0,0,0,0,0,0,0,0
Eyfedef,0,0,0,0,0,0,0,0
FERDAUS,0,0,0,0,0,0,0,0
Fagon,0,0,0,0,0,0,0,0
Fanlotilas,0,0,0,0,0,0,0,0
Fearlessbeard,0,0,0,0,0,0,0,0
Felharne,0,0,0,0,0,0,0,0
Finan,0,0,0,0,0,0,0,0
Finvenen,0,0,0,0,0,0,0,0
Fire Armor,0,0,0,0,0,0,0,0
Fisk,0,0,0,0,0,0,0,0
Genghis Khan,0,0,0,0,0,0,0,0
Graveleye,0,0,0,0,0,0,0,0
Gros jnr,0,0,0,0,0,0,0,0
Grosvenor,0,0,0,0,0,0,0,0
Haiiro,0,0,0,0,0,0,0,0
Heimdall,0,0,0,0,0,0,0,0
Hermit,0,0,0,0,0,0,0,0
Immortal I,0,0,0,0,0,0,0,0
Jeepster,0,0,0,0,0,0,0,0
Jill,0,0,0,0,0,0,0,0
KARMA,0,0,0,0,0,0,0,0
KASS,0,0,0,0,0,0,0,0
Kajko,0,0,0,0,0,0,0,0
Kall,0,0,0,0,0,0,0,0
Karo,0,0,0,0,0,0,0,0
Karo 3,0,0,0,0,0,0,0,0
Karodor2,0,0,0,0,0,0,0,0
Kerilir,0,0,0,0,0,0,0,0
Kit Carson,0,0,0,0,0,0,0,0
Kokosz,0,0,0,0,0,0,0,0
Kordobrek,0,0,0,0,0,0,0,0
Kyperion Du Torbiney,0,0,0,0,0,0,0,0
LETS GO BRANDON,0,0,0,0,0,0,0,0
Ladacznica,0,0,0,0,0,0,0,0
Lady Hawke,0,0,0,0,0,0,0,0
Lanfir,0,0,0,0,0,0,0,0
Lanmoin,0,0,0,0,0,0,0,0
Legon,0,0,0,0,0,0,0,0
Lerinad,0,0,0,0,0,0,0,0
Lilor,0,0,0,0,0,0,0,0
Lirafin,0,0,0,0,0,0,0,0
Lordis,0,0,0,0,0,0,0,0
Luciditee,0,0,0,0,0,0,0,0
MIYAMOTO MUSASHI,0,0,0,0,0,0,0,0
MMM,0,0,0,0,0,0,0,0
MMMm,0,0,0,0,0,0,0,0
MONA,0,0,0,0,0,0,0,0
MONTES,0,0,0,0,0,0,0,0
Maanan,0,0,0,0,0,0,0,0
Mador,0,0,0,0,0,0,0,0
Maelstrom,0,0,0,0,0,0,0,0
Mal the Uncrowned,0,0,0,0,0,0,0,0
Manandis,0,0,0,0,0,0,0,0
Marco,0,0,0,0,0,0,0,0
MarcusTulliusCicero,0,0,0,0,0,0,0,0
Marvilla,0,0,0,0,0,0,0,0
Mausida,0,0,0,0,0,0,0,0
Maximus Decimus,0,0,0,0,0,0,0,0
Mazura,0,0,0,0,0,0,0,0
Meddry,0,0,0,0,0,0,0,0
Minerva,0,0,0,0,0,0,0,0
Mingo 2,0,0,0,0,0,0,0,0
Modnar,0,0,0,0,0,0,0,0
Moginn,0,0,0,0,0,0,0,0
Mogra,0,0,0,0,0,0,0,0
Monster Killer,0,0,0,0,0,0,0,0
Morardin,0,0,0,0,0,0,0,0
Morn,0,0,0,0,0,0,0,0
Muradin Bronzebeard,0,0,0,0,0,0,0,0
NaChos,0,0,0,0,0,0,0,0
Nevyn,0,0,0,0,0,0,0,0
Nobody special,0,0,0,0,0,0,0,0
Norbee1984,0,0,0,0,0,0,0,0
Nygus,0,0,0,0,0,0,0,0
Ognisty Smok,0,0,0,0,0,0,0,0
Ollin,0,0,0,0,0,0,0,0
Osferth,0,0,0,0,0,0,0,0
Painmoon,0,0,0,0,0,0,0,0
Pearl,0,0,0,0,0,0,0,0
Priligy,0,0,0,0,0,0,0,0
Pryntyl,0,0,0,0,0,0,0,0
Puck,0,0,0,0,0,0,0,0
Quick,0,0,0,0,0,0,0,0
RED GUARDIAN,0,0,0,0,0,0,0,0
Rain,0,0,0,0,0,0,0,0
RatkoM,0,0,0,0,0,0,0,0
Ray Gillette,0,0,0,0,0,0,0,0
Raya,0,0,0,0,0,0,0,0
Rebellion,0,0,0,0,0,0,0,0
RedDragon,0,0,0,0,0,0,0,0
Rexfury,0,0,0,0,0,0,0,0
Rhodorix,0,0,0,0,0,0,0,0
Rori,0,0,0,0,0,0,0,0
Sabar,0,0,0,0,0,0,0,0
Sailv,0,0,0,0,0,0,0,0
Samujas,0,0,0,0,0,0,0,0
Sassy Gal,0,0,0,0,0,0,0,0
Saucy Joy,0,0,0,0,0,0,0,0
Secret Keeper,0,0,0,0,0,0,0,0
Sihtric,0,0,0,0,0,0,0,0
Silverblade,0,0,0,0,0,0,0,0
Sir Chthulhu I,0,0,0,0,0,0,0,0
Sire Menion,0,0,0,0,0,0,0,0
Smok,0,0,0,0,0,0,0,0
Smokn,0,0,0,0,0,0,0,0
StarSailor,0,0,0,0,0,0,0,0
Steapa,0,0,0,0,0,0,0,0
Sterling Archer,0,0,0,0,0,0,0,0
TOKUGAWA NOBUNAGA,0,0,0,0,0,0,0,0
Tex Willer,0,0,0,0,0,0,0,0
Tha Supreme,0,0,0,0,0,0,0,0
The Gladiator,0,0,0,0,0,0,0,0
Thor,0,0,0,0,0,0,0,0
Thorn,0,0,0,0,0,0,0,0
Tolnozin,0,0,0,0,0,0,0,0
Tonto,0,0,0,0,0,0,0,0
Tricolor Carioca,0,0,0,0,0,0,0,0
Turbrimir,0,0,0,0,0,0,0,0
Tygojind,0,0,0,0,0,0,0,0
Tygoran,0,0,0,0,0,0,0,0
Tygradi,0,0,0,0,0,0,0,0
Unicorn X,0,0,0,0,0,0,0,0
Vatharia,0,0,0,0,0,0,0,0
Viper I,0,0,0,0,0,0,0,0
Xavier St Cloud,0,0,0,0,0,0,0,0
Xena,0,0,0,0,0,0,0,0
Xenia,0,0,0,0,0,0,0,0
ZaCk,0,0,0,0,0,0,0,0
aganaway,0,0,0,0,0,0,0,0
desperados,0,0,0,0,0,0,0,0
here,0,0,0,0,0,0,0,0
mestesso,0,0,0,0,0,0,0,0
nallekarhu,0,0,0,0,0,0,0,0
nervous,0,0,0,0,0,0,0,0
semoury,0,0,0,0,0,0,0,0
zipkinci,0,0,0,0,0,0,0,0
