PLAYER,ELVEN_10,ELVEN_15,ELVEN_20,ELVEN_25,ELVEN_30,CURSED_20,CURSED_25,TOTAL
Heretical Hermit,0,0,0,0,0,0,444,444
Rhodry,0,6,3,9,1,60,295,374
NEVIO,0,26,56,2,0,208,33,325
Snowberry,148,22,4,0,0,1,0,175
Alberikh,14,24,67,24,0,35,1,165
Sir James III Son of Hadur,0,78,4,4,12,0,6,104
Karodor,0,0,0,66,8,1,20,95
Brandemet,4,10,13,2,12,10,43,94
Morg,0,0,38,3,17,12,2,72
Sir RES,22,40,9,1,0,0,0,72
Diovani,45,20,1,0,0,0,0,66
Fosida,6,36,2,0,0,18,0,62
Thoth,1,54,3,0,0,1,0,59
Xan,17,25,9,0,0,5,0,56
Mr BaCk,2,13,6,13,1,5,15,55
Granidred,14,23,11,0,0,0,0,48
Uhtred,0,0,4,0,0,43,0,47
Fabrinir,0,4,10,8,0,20,4,46
Gradog,0,5,7,33,0,0,0,45
Marvi,10,14,14,0,0,4,0,42
Feli,0,1,20,0,0,20,0,41
Legolas,1,16,15,0,0,7,0,39
Rudolf,2,9,9,0,0,9,10,39
Kosti,0,0,26,0,0,12,0,38
Braveheart,0,3,24,1,9,0,0,37
Menelaos,9,14,13,0,0,0,0,36
Germanicus,0,1,1,24,1,0,6,33
MONTES,31,2,0,0,0,0,0,33
Grozilkree,4,11,11,2,0,3,0,31
Nilaath,2,12,16,1,0,0,0,31
TOKUGAWA NOBUNAGA,11,20,0,0,0,0,0,31
Funfiren,15,15,0,0,0,0,0,30
Mighty Forger,0,0,16,14,0,0,0,30
Lady G,3,15,11,0,0,0,0,29
Mabrinad,1,6,16,0,0,6,0,29
Rainblade,10,19,0,0,0,0,0,29
MADMAN,0,14,13,0,0,0,0,27
Racibor,1,8,11,0,0,5,0,25
Vlad the Impaler,11,5,4,1,0,4,0,25
Eydaen,10,8,3,0,0,1,0,22
Maximus Decimus,1,21,0,0,0,0,0,22
Foxhunter,5,2,2,7,0,0,5,21
Foolish Mortal,0,1,6,5,1,6,1,20
Golgotha,0,3,16,0,0,0,0,19
Thorn,0,1,8,3,0,5,2,19
Amginir,4,6,6,0,0,0,0,16
Grikelv,0,4,9,0,0,2,0,15
Marcelo,5,8,2,0,0,0,0,15
Lorfanor,3,7,4,0,0,0,0,14
Jaakarhu,0,9,4,0,0,0,0,13
doc48,6,3,3,1,0,0,0,13
Lirinir,0,0,0,8,0,0,4,12
Magda Ewa,0,0,6,0,0,6,0,12
Monaoka,1,8,3,0,0,0,0,12
Vatharia,0,8,3,0,0,1,0,12
Kirimand,5,6,0,0,0,0,0,11
Masius,5,5,0,0,0,0,0,10
Mausida,9,1,0,0,0,0,0,10
Diabolik,1,6,1,0,0,1,0,9
Sir Cthulhu I,1,1,3,3,1,0,0,9
Defur,6,1,0,0,0,0,0,7
Logan,0,3,3,0,0,0,0,6
MILI,2,3,0,0,0,0,0,5
Bamsi,1,1,2,0,0,0,0,4
Braveheart JNR,4,0,0,0,0,0,0,4
Mal,0,0,0,0,4,0,0,4
Immortal,0,0,0,1,1,1,0,3
Rudepravo Italiano,0,3,0,0,0,0,0,3
Turbrimir,2,1,0,0,0,0,0,3
Akinomuro,0,2,0,0,0,0,0,2
Bjorn,2,0,0,0,0,0,0,2
DarkAngel,1,0,0,0,0,0,0,1
Kerilir,1,0,0,0,0,0,0,1
Kit Carson,0,1,0,0,0,0,0,1
MONA,0,1,0,0,0,0,0,1
Maedrosin,0,0,1,0,0,0,0,1
Maveriel,1,0,0,0,0,0,0,1
Painmoon,0,1,0,0,0,0,0,1
Rhodorix,1,0,0,0,0,0,0,1
Well Constantino,0,1,0,0,0,0,0,1
3CPo,0,0,0,0,0,0,0,0
Accelerator,0,0,0,0,0,0,0,0
Aegrosad,0,0,0,0,0,0,0,0
AlexLeroc,0,0,0,0,0,0,0,0
Alexander Greek,0,0,0,0,0,0,0,0
Archie,0,0,0,0,0,0,0,0
Arni,0,0,0,0,0,0,0,0
Bad FutherMucker,0,0,0,0,0,0,0,0
Black Mamba,0,0,0,0,0,0,0,0
Brann Bronzebeard,0,0,0,0,0,0,0,0
Brightskin,0,0,0,0,0,0,0,0
Bubino71,0,0,0,0,0,0,0,0
Bunnyman,0,0,0,0,0,0,0,0
Cain,0,0,0,0,0,0,0,0
Catty,0,0,0,0,0,0,0,0
Cenaya,0,0,0,0,0,0,0,0
Cerim,0,0,0,0,0,0,0,0
Cesarz Saleka,0,0,0,0,0,0,0,0
Cesarzowa Cwieka,0,0,0,0,0,0,0,0
Conjudred,0,0,0,0,0,0,0,0
Cosmic Dancer,0,0,0,0,0,0,0,0
Cyril Figgis,0,0,0,0,0,0,0,0
D23,0,0,0,0,0,0,0,0
DAJMITU,0,0,0,0,0,0,0,0
DON IRON MIKE TYSON,0,0,0,0,0,0,0,0
Dabb,0,0,0,0,0,0,0,0
Dacage,0,0,0,0,0,0,0,0
Dafur,0,0,0,0,0,0,0,0
Darvenen,0,0,0,0,0,0,0,0
Deep Inside,0,0,0,0,0,0,0,0
Digore,0,0,0,0,0,0,0,0
Doctor Krieger,0,0,0,0,0,0,0,0
Dr Bruce BANNER,0,0,0,0,0,0,0,0
Dragon Armor,0,0,0,0,0,0,0,0
Drugo,0,0,0,0,0,0,0,0
Dugul,0,0,0,0,0,0,0,0
EL CHAPO GUZMAN,0,0,0,0,0,0,0,0
Eyfedef,0,0,0,0,0,0,0,0
FERDAUS,0,0,0,0,0,0,0,0
Fagon,0,0,0,0,0,0,0,0
Fearlessbeard,0,0,0,0,0,0,0,0
Felharne,0,0,0,0,0,0,0,0
Finan,0,0,0,0,0,0,0,0
Finvenen,0,0,0,0,0,0,0,0
Fire Armor,0,0,0,0,0,0,0,0
Fisk,0,0,0,0,0,0,0,0
Genghis Khan,0,0,0,0,0,0,0,0
Gros jnr,0,0,0,0,0,0,0,0
Grosvenor,0,0,0,0,0,0,0,0
Haiiro,0,0,0,0,0,0,0,0
Heimdall,0,0,0,0,0,0,0,0
Hermit,0,0,0,0,0,0,0,0
Hulk,0,0,0,0,0,0,0,0
Immortal I,0,0,0,0,0,0,0,0
Jeepster,0,0,0,0,0,0,0,0
Jill,0,0,0,0,0,0,0,0
KARMA,0,0,0,0,0,0,0,0
KASS,0,0,0,0,0,0,0,0
Kajko,0,0,0,0,0,0,0,0
Kall,0,0,0,0,0,0,0,0
Karo,0,0,0,0,0,0,0,0
Karo 3,0,0,0,0,0,0,0,0
Karodor2,0,0,0,0,0,0,0,0
Kokosz,0,0,0,0,0,0,0,0
Kordobrek,0,0,0,0,0,0,0,0
Kyperion Du Torbiney,0,0,0,0,0,0,0,0
LETS GO BRANDON,0,0,0,0,0,0,0,0
Ladacznica,0,0,0,0,0,0,0,0
Lady Hawke,0,0,0,0,0,0,0,0
Lanfir,0,0,0,0,0,0,0,0
Lanmoin,0,0,0,0,0,0,0,0
Legon,0,0,0,0,0,0,0,0
Lerinad,0,0,0,0,0,0,0,0
Lilor,0,0,0,0,0,0,0,0
Lirafin,0,0,0,0,0,0,0,0
Lordis,0,0,0,0,0,0,0,0
Luciditee,0,0,0,0,0,0,0,0
MIYAMOTO MUSASHI,0,0,0,0,0,0,0,0
MMM,0,0,0,0,0,0,0,0
MMMm,0,0,0,0,0,0,0,0
Maanan,0,0,0,0,0,0,0,0
Mador,0,0,0,0,0,0,0,0
Maelstrom,0,0,0,0,0,0,0,0
Mal the Uncrowned,0,0,0,0,0,0,0,0
Manandis,0,0,0,0,0,0,0,0
Marco,0,0,0,0,0,0,0,0
MarcusTulliusCicero,0,0,0,0,0,0,0,0
Marvilla,0,0,0,0,0,0,0,0
Mazura,0,0,0,0,0,0,0,0
Meddry,0,0,0,0,0,0,0,0
Minerva,0,0,0,0,0,0,0,0
Mingo 2,0,0,0,0,0,0,0,0
Modnar,0,0,0,0,0,0,0,0
Moginn,0,0,0,0,0,0,0,0
Mogra,0,0,0,0,0,0,0,0
Monster Killer,0,0,0,0,0,0,0,0
Morardin,0,0,0,0,0,0,0,0
Morn,0,0,0,0,0,0,0,0
Muradin Bronzebeard,0,0,0,0,0,0,0,0
NaChos,0,0,0,0,0,0,0,0
Nevyn,0,0,0,0,0,0,0,0
Nobody special,0,0,0,0,0,0,0,0
Norbee1984,0,0,0,0,0,0,0,0
Nygus,0,0,0,0,0,0,0,0
Ognisty Smok,0,0,0,0,0,0,0,0
Ollin,0,0,0,0,0,0,0,0
Osferth,0,0,0,0,0,0,0,0
Pearl,0,0,0,0,0,0,0,0
Priligy,0,0,0,0,0,0,0,0
Pryntyl,0,0,0,0,0,0,0,0
Puck,0,0,0,0,0,0,0,0
Quick,0,0,0,0,0,0,0,0
RED GUARDIAN,0,0,0,0,0,0,0,0
Rain,0,0,0,0,0,0,0,0
RatkoM,0,0,0,0,0,0,0,0
Ray Gillette,0,0,0,0,0,0,0,0
Raya,0,0,0,0,0,0,0,0
Rebellion,0,0,0,0,0,0,0,0
RedDragon,0,0,0,0,0,0,0,0
Rori,0,0,0,0,0,0,0,0
Sabar,0,0,0,0,0,0,0,0
Sailv,0,0,0,0,0,0,0,0
Samujas,0,0,0,0,0,0,0,0
Sassy Gal,0,0,0,0,0,0,0,0
Saucy Joy,0,0,0,0,0,0,0,0
Secret Keeper,0,0,0,0,0,0,0,0
Sihtric,0,0,0,0,0,0,0,0
Silverblade,0,0,0,0,0,0,0,0
Sir Chthulhu I,0,0,0,0,0,0,0,0
Sire Menion,0,0,0,0,0,0,0,0
Smok,0,0,0,0,0,0,0,0
Smokn,0,0,0,0,0,0,0,0
StarSailor,0,0,0,0,0,0,0,0
Steapa,0,0,0,0,0,0,0,0
Sterling Archer,0,0,0,0,0,0,0,0
Tex Willer,0,0,0,0,0,0,0,0
Tha Supreme,0,0,0,0,0,0,0,0
The Gladiator,0,0,0,0,0,0,0,0
Thor,0,0,0,0,0,0,0,0
Tolnozin,0,0,0,0,0,0,0,0
Tonto,0,0,0,0,0,0,0,0
Tricolor Carioca,0,0,0,0,0,0,0,0
Tumitac,0,0,0,0,0,0,0,0
Tygojind,0,0,0,0,0,0,0,0
Tygoran,0,0,0,0,0,0,0,0
Tygradi,0,0,0,0,0,0,0,0
Unicorn X,0,0,0,0,0,0,0,0
Viper I,0,0,0,0,0,0,0,0
Xavier St Cloud,0,0,0,0,0,0,0,0
Xena,0,0,0,0,0,0,0,0
Xenia,0,0,0,0,0,0,0,0
ZaCk,0,0,0,0,0,0,0,0
aganaway,0,0,0,0,0,0,0,0
desperados,0,0,0,0,0,0,0,0
idaco,0,0,0,0,0,0,0,0
mestesso,0,0,0,0,0,0,0,0
nallekarhu,0,0,0,0,0,0,0,0
nervous,0,0,0,0,0,0,0,0
semoury,0,0,0,0,0,0,0,0
zipkinci,0,0,0,0,0,0,0,0
